XXXXXXXXXXXXXXXXXXXXXXXXXXX
XMQQXXXXQQQQQQQQQQQXXXXQQQX
XQXQOQTQQXXXXXXXXXQQTQOQXQX
XQXXXXXQXXXQQQQQXXXXXQXXXQX
XQQQGQQQQQTQXQXQTQQQQQGQQQX
XXXXXXXTXXXQXMXQXQXXXXXXXXX
XQQGQQQQQQTQXQXQTQQQQQQGQQX
XQXXXXXQXQXQQQQQXQXTXXXXXQX
XQOQQQXQXQXXXXXXXQXQQQQQOQX
XXQXXQXQQQQQQQQQQQXQXQXXQXX
XXXXXXXXXXXXXXXXXXXXXXXXXXX